19,10,10,10,10,2,2,10,10,10,10,6,3,2,10,6,3,6,7,3,10,6,3,2,6
5,3,10,10,6,5,9,6,3,10,14,5,13,5,3,12,5,9,4,5,7,9,12,5,13
13,5,3,6,5,13,3,12,1,10,6,5,3,12,1,10,12,3,12,9,4,11,6,9,6
3,12,5,9,8,10,12,7,1,14,9,8,12,7,5,3,6,9,10,14,9,6,5,3,12
1,6,13,3,6,3,6,9,12,3,10,6,11,8,12,5,9,10,10,2,14,9,4,9,6
5,9,10,12,5,5,9,10,6,5,7,5,3,10,6,9,6,3,6,9,10,10,8,14,5
5,3,10,6,9,8,10,14,5,5,5,9,12,3,8,14,5,5,1,6,3,10,6,3,4
5,5,11,4,3,6,3,10,12,5,1,6,3,12,3,10,12,5,5,5,9,6,13,5,5
5,1,6,5,13,5,9,10,10,12,5,5,9,10,12,11,10,4,5,9,6,5,3,12,13
5,13,5,9,10,4,11,6,3,6,5,9,10,6,3,2,6,13,5,7,1,12,9,2,6
9,6,5,3,6,9,6,5,5,5,9,10,6,9,12,5,9,6,5,1,12,3,6,13,5
7,5,1,12,5,7,5,5,5,9,2,6,5,3,10,12,7,9,12,5,7,5,9,10,12
1,12,5,3,12,1,12,5,5,3,12,13,5,5,11,2,8,10,14,9,4,9,10,10,6
9,6,13,5,11,4,7,1,12,5,3,10,12,9,6,9,10,2,10,6,9,2,10,14,5
7,9,6,9,6,5,5,9,6,5,1,14,3,6,5,3,6,5,3,12,3,12,3,10,4
9,6,9,10,12,5,5,3,12,9,12,3,12,5,1,12,5,5,9,6,5,7,5,11,12
3,12,3,10,10,12,1,12,3,10,10,12,3,12,5,3,12,9,6,9,8,12,9,10,6
1,10,12,3,6,3,8,14,5,7,3,6,5,11,12,5,3,6,1,14,3,6,3,10,4
5,11,2,12,5,13,3,10,12,5,5,5,9,10,6,9,12,5,13,3,12,5,5,11,12
9,6,9,6,9,10,12,3,6,1,12,9,10,6,9,10,6,5,3,12,3,4,9,10,6
7,9,10,12,11,2,10,12,5,5,3,10,6,1,14,3,12,1,12,3,12,1,14,3,4
9,2,14,3,2,12,3,10,12,5,5,11,4,9,6,9,6,5,3,4,7,5,3,12,5
3,12,3,12,5,11,4,3,10,12,1,6,5,7,9,6,5,13,5,13,5,5,5,3,12
1,6,9,6,9,6,13,9,6,11,12,5,9,4,3,12,9,6,9,6,5,13,5,9,6
13,9,10,8,14,9,10,10,8,10,10,12,11,12,9,10,10,8,10,12,9,10,12,11,44
