19,10,10,6,7,3,10,2,14,3,6,3,6,3,6
1,10,6,9,12,5,7,9,10,12,9,12,5,5,5
5,7,9,10,10,12,1,10,10,2,14,3,12,13,5
5,1,10,6,3,6,9,6,7,5,11,12,11,2,4
9,12,11,8,12,9,10,12,9,8,10,10,10,12,45
