19,2,10,14,3,2,14,3,6,3,6,3,6,3,6
5,9,10,10,12,9,6,5,9,12,9,12,9,12,5
9,10,10,10,6,7,5,9,10,10,10,10,10,6,5
7,3,2,14,5,5,9,10,6,3,2,14,3,12,5
9,12,9,10,8,8,10,14,9,12,9,10,8,14,45
