19,14,3,10,2,14,3,10,14,11,10,2,6,11,6
1,10,12,7,9,10,12,3,6,3,10,12,9,10,4
5,3,10,4,3,2,6,5,9,12,3,10,10,6,5
9,12,7,5,13,5,9,12,3,6,5,7,3,12,5
11,10,8,8,10,12,11,10,12,9,8,12,9,10,44
