19,10,2,6,11,10,2,10,6,3,6,11,2,10,6
9,14,5,9,6,3,12,7,5,13,9,6,5,3,12
3,10,12,3,8,12,3,8,12,3,10,12,5,9,6
5,3,6,13,3,6,13,3,10,12,3,6,9,14,5
9,12,9,10,12,9,10,8,10,10,12,9,10,10,44
