19,10,2,2,14,3,10,10,6,3,10,2,14,3,14
9,14,5,13,3,12,11,6,5,9,6,9,6,9,6
3,10,12,3,12,3,10,4,1,14,1,14,1,14,5
1,6,3,12,3,12,3,12,9,10,12,3,12,3,12
13,9,8,10,12,11,8,10,10,10,14,9,10,8,46
